puman	美洲狮
spotv	看出，发现
evidencen	证据
accumulatev	积累，积聚
obligev	使…感到必须
huntn	追猎；寻找；v.打猎
blackberryn	黑莓
human	人类
cornerv	使走投无路，使陷入困境；n.角落
trailn	一串，一系列
printn	印痕
clingv	粘
convincev	使…信服
somehowad	不知怎么搞的，不知什么原因
disturb	v.令人不安
equal	v.等于
vicarn	牧师
raisev	募集，筹(款)
torchlightn	电筒光
goddessn	女神
archaeologistn	考古学家
Aegeana	爱琴海的
explorev	考察，勘探
promontoryn	海角
prosperousa	(经济上)繁荣的，昌盛的
civilization	n.文明
storey	n.楼层
drainage	n.排水
worship	n.祟拜
sacred	a.宗教的，神圣的
fragment	n.碎片
remains	n.遗物，遗迹，废墟
classical	a.(希腊和罗马)古文化的
reconstruct	v.修复
rest	v.倚放，放置
hip	n.屁股，臀部
full-length	a.(裙衣)拖地长的
graceful	a.优雅的
identity	n.身份
manual	a.体力的
collar	n.衣领
sacrifice	v.牺牲，献出
Privilege	n..好处，特权;优特
dustman	n.清洁工
corporation	n.公司
overalls	n.工作服
shower	n.淋浴
secret	n.秘密
status	n.地位
editor	n.编辑
extreme	n.极端
statistics	n.统计数字
journalist	n.新闻记者
president	n.总统
palace	n.王宫；宏伟的住宅
publish	v.出版
fax	n.传真
impatient	a.不耐烦的
fire	v.解雇
originally	ad.起初，原先，从前
smash-and-grab	n.砸窗户抢劫
arcade	n.有拱廊的街道(两旁常设商店)
Piccadilly	n.皮卡迪利大街（伦敦市中心一条著名的街道）
jewellery	n.珠宝(总称)
necklace	n.项链
ring	n.戒指；环形物
background	n.背景
velvet	n.天鹅绒，丝绒
headlight	n.(汽车等)前灯
blare	v.发嘟嘟声，吼叫
staff	n.全体工作人员
raid	n.偷袭
scramble	v.爬行
fantastic	a.非常大的
ashtray	n.烟灰缸
mutilate	v.使残缺不全，毁坏
chew	v.咀嚼
fiancé	n.未婚夫
microwave	n.微波，微波炉
oven	n.炉灶
safekeeping	n.妥善保管
Newcastle	n.纽卡斯尔(英国港口城市)
identify	v.鉴定，识别
spokeswoman	n.女发言人
monastery	n.寺院，修道院
St.Bernard	圣伯纳德
pass	n.关隘
watchdog	n.看门狗
rashly	a.莽撞地，冒失地
enclosure	n.围场，圈地
monk	n.和尚，僧侣,修道士
privacy	n.清静，隐居
skier	n.滑雪者
Easter	n.复活节
fascinate	v.迷住，吸引住
affectionate	a.充满深情的，柔情的
mysterious	a.神秘的，难以理解的
submissive	a.服从的，顺从的
feline	a.猫的
independence	n.独立，独立性
high-rise	a.高层的
windowsill	n.窗槛，窗台
paratrooper	n.伞兵
squirrel	n.松鼠
air-resistance	n.空气阻力
impact	n.冲击力
Southampton	n.南安普敦(英国港口城市)
colossal	a.庞大的,巨大的
watertight	a.不漏水的
compartment	n.(轮船的)密封舱
flood	v.充满水
float	v.漂浮，飘浮
tragic	a.悲惨的
liner	n.班船, 大客轮；班机
voyage	n.航行
iceberg	n.冰山
lookout	n.瞭望员
collision	n.碰撞
narrowly	ad.刚刚，勉强地
miss	v.避开
slight	a.轻微的
tremble	v.震颤
faint	a.微弱的
horror	n.恐惧
abandon	v.抛弃
plunge	v.投入，跳入；陷入
lifeboat	n.救生船
guilty	a.犯罪的，违法的
tolerant	a.宽容的
declare	v.申报
hardened	a.有经验的
professional	a.职业的，专业的
smuggler	n.走私者
officious	a.爱管闲事的
confidently	ad.自信地
dreadful	a.可怕的，一团糟的
pounce	v.猛抓，扑住
perfume	n.香水
sarcastically	ad.讽刺地
exempt	a.被免除的
duty	n.税
gel	n.凝胶，发胶
mixture	n.混合物
unscrew	v.拧开
nostril	n.鼻孔
chalk	n.粉笔
baggage	n.行李
desert	v.(军队中)开小差
unrealistic	a.不真实的
paradise	n.天堂，乐土
wretched	a.可怜的，艰苦的
starve	v.挨饿
element	n.成分
opportunity	n.机会
coral	n.珊瑚
Virgin	维尔京群岛
Miami	n.迈阿密(美国最南的城市)
dinghy	n.救生筏，小船
Caribbean	n.加勒比海
spear	捕鱼枪
lobster	n.龙虾
tanker	n.油轮
genuinely	ad.由衷地
Robinson Crusoe	鲁滨孙·克鲁索(《鲁滨孙漂流记》主人公)
costume	n.化装服
consist	v.由…组成
sheet	n.被单
effective	a.有明显效果的，有作用的; 生效的
comfortable	a.舒适的
storeroom	n.储藏室
electricity	n.电
ammeter	n.电表
pace	n.一步
flee	v.逃走
slam	v.砰地关上
gangster	n.歹徒，强盗
Chicago	n.芝加哥(美国城市)
protection	n.保护
promptly	ad.准时地；迅速的
destroy	v.毁掉；消灭
remarkable	a.不寻常的
band	n.帮，团伙
Florence	n.佛罗伦萨(意大利城市)
city-state	n.(古代)城邦
hire	v.租出，雇佣
prince	n.(小附属国的)君主，诸侯；王子
Florentine	n.佛罗伦萨人
funeral	n.葬礼
dedicate	v.奉献，题献给
memory	n.纪念
valiant	a.英勇的
appreciate	v.欣赏，感激
pocket	零用钱
rattle	v.格格作响
thrifty	a.节俭的
nephew	n.侄子，外甥
bounce	v.弹起，跳起
pavement	n.人行道
stick	v.卡住，夹住，不能再动
brigade	n.旅，(消防)队
grease	n.润滑油
prize	a.珍贵的，宝贵的
tie	v.拴，系
theft	n.偷盗行为，偷盗案
accuse	v.指控
deny	v.否认
ashamed	a.感到羞耻，惭愧
apologize	v.道歉
dye	v.染
suspension	n.悬，吊
agreeable	a.宜人的
situation	n.地点，地方
locate	v.位于
immortal	a.永生的，流芳百世的
Brooklyn	n.布鲁克林
Staten	n.斯塔顿(岛)
span	n.跨度
cable	n.缆索
concrete	n.混凝土
suspend	v.悬挂
length	n.根，段; 长度
estimate	v.估计
capacity	n.承受量，容量
immensity	n.巨大
elegant	a.优美别致的
faintly	ad.微细地
current	n.电流,水流,气流
sculpture	n.雕塑
mistaken	a.错误的
gallery	n.美术馆
exhibit	n.展品，陈列品
oddly	ad.古怪的
attach	v.连，系
sphere	n.球体
magnetize	v.使磁化
repel	v.排斥
flicker	v.闪烁
emit	v.放射
flash	v.闪光；闪过
prehistoric	a.史前的，老掉牙的
electronic	a.电子的
peculiar	a.奇异的
shock	v.令人震惊，刺激人
emotionally	ad.感情上
dear	a.亲爱的；珍贵的；昂贵的
kidnapper	n.绑架者，拐骗者
considerable	a.相当大的
wealthy	a.富的，有钱的
orderly	a.有规律的
disappearance	n.失踪
anonymous	a.匿名的
ransom	n.赎金
cardboard	n.硬纸板
withdraw	v.(从银行)取钱
punctually	ad.准时地
astound	v.使吃惊
pioneer	n.先驱
lord	n.对(英国)贵族的尊称；勋爵
Calais	n.加来(法国港口城市)
overland	a.陆上的
boxing	n.拳击
boxer	n.拳击手
bare	a.赤裸的；空荡的
prizefighter	n.职业拳击手(尤指古时赤手拳击手)
crudea	粗野的
marquis	n.侯爵
technically	ad.严格根据法律意义地
science	n.科学
popularity	n.名望
adore	v.崇拜，爱戴；非常喜欢
alike	ad.一样地
fame	n.名声
eminent	a.著名的，杰出的
bitterly	ad.厉害地
bet	v.打赌
academy	n.专业学校
extravagant	a.浪费的，奢侈的
poverty	n.贫困
run	v.(戏剧，电影等)连演，连映
lines	n.(剧本中的)台词
part	n.剧中的角色，台词
falter	v.支吾，结巴说
cast	v.选派……扮演角色
role	n.角色
aristocrat	n.贵族
imprison	v.关押
Bastille	n.巴士底狱
gaoler	n.监狱长，看守
colleague	n.同事
curtain	n.(舞台上的)幕布
reveal	v.使显露;泄漏
cell	n.单人监房，监号
blank	a.空白的
squint	v.眯着(眼)看，瞄
dim	a.昏暗的
sire	n.(古用法)陛下
proceed	v.继续进行
poison	n.毒药
illogical	a.不合逻辑的，无章法的
octopus	n.章鱼
delicacy	n.美味，佳肴
repulsive	a.令人反感的，令人生厌的
stomach	n.胃
turn	v.感到恶心，反胃
fry	v.油炸
fat	n.(动物、植物)油
abuse	n.辱骂，责骂
snail	n.蜗牛
luxury	n.奢侈品，珍品
associate	v.联想到
despise	v.鄙视
appeal	v.引起兴致
shower	n.淋浴
stroll	n.溜达，散步
impulse	n.冲动
dozen	n.12个，一打
fancy	v.喜爱，喜欢
skeleton	n.骷髅
seemingly	ad.表面上地
respectable	a.体面的，雅观的
conceal	v.隐藏，隐瞒
vivid	a.生动的
dramatic	a.令人激动的，扣人心弦的
ruin	v.毁坏
heroine	n.女主人公
fiction	n.小说
varying	a.不同的
medicine	n.医学
guestroom	n.(家庭中的)客房
unpack	vt.(从箱中)取出
stack	v.(整齐地)堆放，排放；n.堆
underclothes	n.内衣
drawer	n.抽屉
petrify	v.使惊呆
dangle	v.悬挂
sway	v.摇摆
unsympathetic	a.不表同情的，无动于衷的
medical	a.医学的
impressive	a.给人深刻印象的
steamship	n.蒸汽轮船
vessel	n.轮船，大木船
era	n.时期，时代
Java	n.爪哇(印度尼西亚一岛)
rudder	n.舵
roll	v.颠簸，摇摆
steer	v.掌握方向
temporary	a.临时的
plank	n.大块木板
fit	v.安装
Equator	n.赤道
delay	v./n.耽误
influence	v.影响
pride	v.骄傲
taste	n.鉴赏力;品尝
exert	v.施加
subtle	a.微妙的，难以捉摸的
advertiser	n.做广告的人
classify	v.分类
magic	a.有奇妙作用的
sample	n.样品
devise	v.设计，想出
capture	v.吸引，赢得
manufacturer	n.生产厂家，制造商
wheelbarrow	n.独轮手推车
boot	n.(汽车尾部的)行李箱
ingredient	n.配料
crane	n.起重机
anticipate	v.预期，预料
philosopher	n.哲学家
wisdom	n.智慧
priest	n.牧师
spiritual	a.精神上的
grudge	v.不愿给，舍不得给
surgeon	n.外科大夫
passer-by	n.过路人(复数passers-by)
dignity	n.尊严
deliberately	ad.故意地
consequence	n.后果，结果
afflict	v.使苦恼，折磨
ease	n.容易
nature	n.大自然
contempt	n.蔑视
envious	a.嫉妒的
wares	n.货物，商品
anchor	v.停航下锚
deck	n.甲板
silverware	n.银器
tempt	v.吸引；引诱
bargain	v.讨价还价; n.便宜货
disembark	v.下船上岸
assail	v.纠缠
marble	n.小玻璃球
inscribe	v.刻写，雕
favour	n.好处，优惠
gesticulate	v.(讲话时)打手势
outrageous	a.出人预料的；令人不悦的
thrust	v.硬塞给；强行挤进
largely	ad.在很大程度上
comic	a.喜剧的，可笑的
universal	a.普遍的
comedian	n.滑稽演员，喜剧演员
distasteful	a.讨厌的
pester	v.一再要求，纠缠
dread	v.惧怕
recovery	n.康复
plaster	n.熟石膏
console	v.安慰，慰问
hobble	v.瘸着腿走
compensate	v.补偿
mumble	v.喃喃而语
labourer	n.劳动者(也做laborer)
overnight	ad.一夜期间
hay	n.干草
corn	n.谷物
moonlight	n.月光
conscientious	a.认真的
suspect	v.怀疑
desert	v.(军队中)开小差
regiment	n.(军队)团
action	n.战斗
recluse	n.隐士
lovable	a.可爱的
eccentric	n.(行为)古怪的人
disregard	v.不顾，无视
convention	n.习俗，风俗
conscious	a.感觉到的，意识到的
invariably	ad.总是，经常地
routine	n.常规；惯例; a.常规的
shrewd	a.精明的
eccentricity	n.怪癖
legendary	a.传奇般的
snob	n.势利小人，谄上欺下的人
intensely	ad.强烈地
bedraggled	a.拖泥带水的；又脏又湿的
dump	v.把……砰的一声抛下
apologetic	a.道歉的
reprimand	v.训斥
stage	v.暗中策划
elaborate	a.精心构思的；精致的
salvage	v./n.救助，营救，打捞;
Barents	n.巴伦支(海)
sunken	a.沉没的
cargo	n.货物
bullion	n.金条；银条
scour	v.彻底搜索
chest	n.大箱子
contents	n.(复数)所装的东西
belongings	n.(复数)所有物
item	n.物件
cruiser	n.巡洋舰
find	n.找到的物品
log book	航海日志
piece	v.拼成整体
convoy	v./n.护航
torpedo	v.用鱼雷攻击
submarine	n.潜水艇
naval	a.海军的
ministry	n.(政府的)部
prelude	n.序幕，前奏
unforeseen	a.意料之外的
series	n.系列
catastrophe	n.大祸，灾难
crockery	n.陶器，瓦器
suburb	n.郊区
collide	v.猛撞
learner	n.初学者
panic	n.惊慌，恐慌
windscreen	n.(汽车的)挡风玻璃
alongside	prep.在……的旁边，与……并排
slide	v.滑；回避
stray	a.迷失的，离群的；v.迷路，偏离
confusion	n.混乱
greedily	ad.贪婪地
devour	v.狼吞虎咽地吃
antique	n.古董，古玩
fascination	n.魅力，迷惑力
forbidding	a.望而生畏的，望而却步的
muster	v.鼓起
pretentious	a.自命不凡的，矫饰的
labyrinth	n.迷宫
musty	a.陈腐的，发霉的
rarity	n.稀世珍品
assorted	a.各式各样的
junk	n.破烂货，废品
carve	v.镌刻
dagger	n.短剑，匕首
litter	v.杂乱地布满；n.垃圾
dedicated	a.专心致志的；全身心投入的
bargain hunter	n.到处找便宜货买的人
dealer	v.商人
cherish	v.期望，渴望；珍爱
amply	ad.足够地
masterpiece	n.杰作
mere	a.仅仅的
prize	a.珍贵的，宝贵的
miniature	a.小巧的，小型的
composition	n.构图
justice	n.正义，公正；司法
court	n.法院
law	n.法律
innocence	n.无辜
undertake	v.承担，着手做
arduous	a.艰苦的，艰难的
abstract	a.抽象的
concept	n.概念，观念
mete	给予，处置
interference	n.干涉
accord	v./n.一致
premises	n.房屋
convert	v.转变，改变
disused	a.不再用的，废弃的
fireplace	n.壁炉
muffle	v.捂住，压抑
chip	v.砍，削，凿；碎裂
blacken	v.使变黑
emerge	v.(从某处)出现
credulous	a.轻信的
improbable	a.不大可能的
obscure	a.不起眼的；v.遮掩，模糊
maidservant	n.女仆，女佣
presume	v.假定
wickedly	ad.心眼坏地，居心叵测地
plot	v.密谋
downfall	n.倒台，垮台
naïve	a.天真的
unacceptable	a.不能接受的
conspire	v.(事件)巧合促成
incredible	a.难以置信的
resemblance	n.相似
scorn	n.嘲弄，挖苦
acquaint	v.使了解
reunite	v.使团聚
assume	v.假定，认为
express	n.快车 a.高速的
punctual	a.准时的
condition	v.使习惯于
unshakable	a.不可动摇的
faith	n.信任
cancel	v.取消
exceptionally	ad.例外地
dislocate	v.打乱(计划等)
blame	v.责怪
consult	v.请教，查阅
direct	ad.径直地
odd	a.奇怪的，异常的
reflect	v.细想
advantage	n.优势
mighty	a.强大的，有力的
dawdle	v.慢吞吞地动或做
chug	v.咔嚓咔嚓地响
lodge	v.提出；n.小屋，(旅游区的)小旅馆
complaint	n.抱怨
triumph	n.胜利; v.战胜
asterisk	n.星号(*)
conduct	v.引向，引导
calendar	n.历法，日历
historian	n.历史学家
unique	a.无与伦比的；独特的
steadily	ad.不断地
solely	ad.唯一地
video	n.录像
CD-ROM	n.(只读)光盘驱动器
bewilder	v.令人眼花缭乱
deduce	v.推断，推理
scanty	a.不足的，贫乏的
mammoth	n.(古生物)长毛象
tusk	n.獠牙，长牙，象牙
nomad	n.游牧民
correlate	v.使相互联系
clue	n.线索
insignificant	a.不重要的
shed	v.使流出，泻
advent	n.出现，到来，来临
agriculture	n.农业
assumption	n.假定，设想
dot	n.小圆点
symbol	n.符号
engrave	v.雕刻
ivory	n.象牙制品
phase	n.月相，天相
primitive	a.原始的
depict	v.描画，描绘
rough	a.崎岖不平的
boulder	n.大石块
pit	v.使得坑坑洼洼
perturb	v.使不安
underestimate	v.低估
swerve	v.急转弯
scoop	v.挖出
hammer	v.(用锤)击打，锤打
ominously	ad.有预兆的，不祥的
rip	v.划破，撕，扯
zigzag	n."之"字形
shallow	a.浅的
grind	v.磨擦，磨
petrol	n.汽油
stretch	n.一大片(平地或水)
obstacle	n.障碍
clump	n.丛，簇
fissure	n.(石，地的)深缝
renew	v.重复；更新
pleading	n.恳求
gear	n.(汽车)排档
astride	prep.骑，跨
crack	n.缝隙
halt	n.停
dashboard	n.(汽车上的)仪表盘
hoax	n.骗局，戏弄
deception	n.欺骗，骗局
self-respecting	a.自重的，自尊的
indulge	v.使沉迷；享受
pneumatic	a.气动的
drill	n.钻
silly	a.无意义的，无聊的
advance	a.预先的，事先获得的
archway	n.拱形门楼
remonstrate	v.规劝，告诫
ironically	ad.讽刺地
permission	n.许可
grant	v.同意，准予
illusion	n.幻想，错觉
pastoral	a.田园的
breed	v.培育
rapture	n.欣喜
extol	v.赞美，颂扬
superior	a.优越的
cockcrow	n.鸡叫
twitter	v.(鸟)吱吱叫，嘁嘁喳喳叫
glint	v.闪烁
pasture	n.牧场
idyllic	a.田园诗的
virtually	ad.几乎，差不多
dubious	a.可疑的，怀疑的
privilege	n.好处，特权
misery	n.苦难
acquaintance	n.熟人
treat	n.难得的乐事，享受
dweller	n.居住者
stagger	v.摇晃，蹒跚
exotic	a.异乎寻常的，外来的
glow	n.白炽光
descend	v.下落，降临
tuck	v.缩进，隐藏
obstinately	ad.固执地，顽固地
caveman	n.(远古)洞穴人
pot-holing	n.洞穴探险，洞穴探险运动
solitude	n.孤独，寂寞
lure	v.引诱，诱惑
pot-holer	n.洞穴探险者
rambler	n.漫步者，散步者
undertaking	n.任务，工作
foresight	n.预见；深谋远虑
foretell	v.预言
Grenoble	n.格里诺布尔
chasm	n.断层，裂口，陷坑
flaw	n.小裂缝；缺点，瑕疵
distinguished	a.杰出的，著名的
Everest	n.珠穆朗玛峰
wade	v.涉水
waterfall	n.瀑布
gear	n.(汽车)排档
inflatable	a.可充气的
rubble	n.碎瓦，瓦块
insistent	a.连续的，不断的
boom	v.轰响
waterspout	n.强大的水柱
cleft	n.裂隙，开口
cavern	n.大洞穴
stalagmite	n.石笋
stalactite	n.钟乳石
limestone	n.石灰石
glisten	v.闪烁
eerie	a.引起恐惧的，可怕的
dome	n.穹窿，圆顶
insure	v.投保
fete	n.游园会
admittedly	ad.公认的
purchase	v.买
annual	a.一年一度的
teenager	n.(13岁至19岁的)青少年
capsize	v.(船)翻
shiver	v.打颤，发抖
dive	v.(头向下)跳水
haul	v.拖曳
hawser	n.粗缆绳
rim	n.(圆形物品的)外沿，边
winch	n.绞车(带有绞盘的车)
premium	n.保险费
recover	v.使……得到补偿，弥补
agonizing	a.精神紧张的，提心吊胆的
perch	v.处于(高处)
precariously	ad.危险地，不稳固地
overbalance	v.失去平衡
clamp	n.夹钳，夹板
vertically	ad.垂直地
torrent	n.激流，洪流
rebound	v.弹回
positively	ad.绝对地，完全地
compartment	n.(轮船的)密封舱
cramped	a.窄小的
stuffy	a.憋气的，闷气的
monotonous	a.枯燥的，乏味的，单调的
rhythm	n.有节奏的运动
click	v.发出咔哒声
lull	v.催人欲睡
snatch	n.短时，片段
sleeper	n.(火车等的)卧铺
fumble	v.乱摸，摸索
inspection	n.检查
inevitably	ad.必然地，不可避免地
destination	n.目的地
exhaust	v.使精疲力尽
motorway	n.快车道
ferry	n.渡船
cruise	n.巡游船
civilize	v.使文明
spacious	a.宽敞的
seasick	a.晕船的
intimidate	v.恐吓，恫吓
disadvantage	n.短处，缺点
exhilaration	a.使人高兴的，令人兴奋的
escapist	n.逍遥者，逃避现实者
sip	v.呷，啜
champagne	n.香槟酒
refinement	n.精心的安排
breathtaking	a.激动人心的；不寻常的
soar	v.高飞，翱翔
effortlessly	ad.不费力地
landscape	n.景色
fresh	a.精神饱满的
uncrumpled	a.没有垮下来
democratic	a.民主的
restrict	v.限制
abuse	n.辱骂，责骂
contention	n.论点
quintuplet	n.五胞胎之一
obscurity	n.默默无闻
radically	ad.彻底地，完全地
exclusive	a.独占的，独家的
untold	a.数不尽地，无限的
South	南达科他州(美国)
perpetual	a.永久的
nursery	n.育婴室，保育室
commercialization	n.商品化
commodity	n.商品
plead	v.找(借口)，辩解
ignorance	n.无知，不懂
publication	n.出版物，出版
newlyweds	n.新婚夫妇
gaily	ad.愉快地，高兴地
leisure	n.空闲
keen	a.热心的，渴望的
advisory	a.咨询的
novice	n.新手
consumer	n.消费者，顾客
assemble	v.装配，组装
outlet	n.出路，出口
creative	a.创造性的
handyman	n.手巧的人，能工巧匠
resourceful	a.足智多谋的
fuse	v.由于烧断保险丝而短路
rickety	a.要散架的，晃动的
clog	v.堵塞
delusion	n.错觉
lawn mower	割草机
adjustment	n.调整
screw	n.螺丝钉
dismantle	v.拆卸
chunk	n.(厚)块
snap	v.绷断
insurmountable	a.不能克服的，难以对付的
jigsaw	n.线锯
nag	v.唠叨不休
rust	v.生锈
pollution	n.污染
overpopulated	a.人口多的
over-industrialized	a.过度工业化的
sheer	a.纯粹的，不掺杂的
worldwide	ad.在全世界
overwhelm	v.制服，使不知所措
pollute	v.污染
pesticide	n.杀虫剂
fertilizer	n.肥料
salmonella	n.沙门氏菌
listeria	n.利斯特杆菌
vegetarian	n.吃素的人
organically-grown	a.有机培植的(不施化肥和其他化学药品培植)
insidious	a.暗中为害的
urban	a.城市的
burglar	n.窃贼
burgle	v.入室偷窃
scream	v.尖叫
profound	a.极度的
irritation	n.烦躁
incessantly	ad.连续不断地
whine	v.发呜呜声
helicopter	n.直升飞机
maximum	a.最大的
technology	n.技术
contribution	n.贡献
mobile	a.可移动的
snore	v.打鼾
offender	n.冒犯者
staggering	a.令人惊愕的
trumpet	v.吹号
partner	n.伙伴
inaccessible	a.难接近的，达不到的
hospitable	a.好客的
hostile	a.不友好的，有敌意的
vicinity	n.周围,附近
architectural	a.建筑的
fresco	n.壁画
abruptly	ad.突然地，意外地
tramp	v.徒步行进
moor	v.(用绳、链、锚)系(船)
ferry	n.渡船
straggle	v.蔓延，散乱分布
dilapidated	a.陈旧破烂的，倒塌的
sardine	n.沙丁鱼，沙丁鱼罐头
rag	n.破烂衣服
motionless	a.不动的
procession	n.行列，成队的人群
shawl	n.披巾，围巾
peer	v.凝视，盯着
quicken	v.加快
rambling	a.杂乱无章的
sentimentally	ad.感情上，多情地
lavishly	ad.慷慨地，大方地
immaculate	a.清洁的，无污点的
parquet	n.镶木地板
gleam	v.发亮，闪光
preside	v.指挥
invisible	a.看不见的，无形的
scrub	v.擦拭，刷洗
enlightened	a.开明的，教化的
fickleness	n.变化无常
unrelenting	a.不屈不挠的，不松懈的
disillusion	v.使幻想破灭
industriousness	n.勤奋
qualification	n.资格，能力
mirth	n.欢笑，高兴
stack	v.(整齐地)堆放，排放；n.堆
cellar	n.地窖
resolution	n.决心
mentally	ad.内心里
compile	v.编辑，编制
formidable	a.令人畏惧的
recur	v.再发生，又出现
regularity	n.规律性
accomplishment	n.成就
attainment	n.达到；成就，造诣
inveterate	a.根深蒂固的
self-improvement	n.自我完善
scheme	n.简单的计划，方案
ambitious	a.雄心勃勃的
pitfall	n.意外的困难，易犯的错误
modest	a.要求不过分的,谦虚的
assiduously	ad.刻苦地
self-discipline	n.自我约束
frame	n.躯体
betray	v.暴露，显露
troop	v.成群结队地走动
unsettle	v.使不安
taunt	n./v.嘲笑，奚落人的话
jibe	n.嘲弄，挖苦
good-humouredly	ad.和气地，心情好地
wane	v.逐渐变小，变弱
diminish	v.减少，缩小
hypnotize	v.使欲睡，使朦胧
undoing	n.祸根，毁灭的原因
screen	n.电视机屏幕
full-time	a.专职的
technician	n.技师
software	n.软件
IBM	国际商用机器公司
DOS	磁盘操作系统(Disk Operating System)
Microsoft	n.(美国)微软公司
user-friendly	a.容易操作的，好用的
multimedia	a.多媒体的
alternative	a.选择的
diagnose	v.诊断
relieve	v.减轻
accountant	n.会计
repetitive	a.重复的
clerical	a.办公室工作的
Internet	n.国际交互网
network	n.网络
permanent	a.永久的
tint	v.给染色
delicate	a.淡色的
shade	n.色度
observant	a.观察力敏锐的
grayish	a.浅灰色的
dispel	v.驱散，消除
outlandish	a.稀奇古怪的
acquisition	n.获得
cosmetic	n.化妆品
outrageous	a.出人预料的；令人不悦的
fanciful	a.想象出来的
insoluble	a.不可溶解的
prompt	v.敦促，激励
exclusive	a.独占的，独家的
syllable	n.音节
bewilderment	n.迷惑，糊涂
freckle	n.雀斑
evidently	ad.显然地，明显地
weird	a.奇异的，古怪的
concoction	n.调制品
intoxicate	v.陶醉，得意忘形
blank	a.空白的
discreetly	ad.谨慎地
clutch	v.抓住
adorn	v.装饰，打扮
evolve	v.逐渐形成
high-handed	a.高压的，专横的
incompetent	a.不够格的，不称职的
over-zealously	ad.过分热情地
safeguard	v.保护
parliamentary	a.国会的
qualified	a.合格的
grievance	n.不平，冤屈
Justiteombudsman	n.(瑞典的)司法特派员
ombudsman	n.(瑞典和英国的)司法特派员
secretive	a.保密的
correspondence	n.来往信件
alter	v.改变
accusation	n.谴责，指控
ascertain	v.查出，查明
prejudiced	a.有偏见的，不公平的
prompt	v.敦促，激励
insect	n.昆虫
wage	v.进行(斗争)
contaminate	v.弄脏
provocation	n.惹怒
spider	n.蜘蛛
wasp	n.黄蜂
moth	n.飞蛾
ant	n.蚂蚁
revulsion	n.厌恶
horde	n.群
uncanny	a.神秘的，不可思议的
erase	v.擦，抹去
praying mantis	n.螳螂
entranced	a.出神的
beetle	n.甲虫
sheltered	a.伤不着的，无危险的
luscious	a.甘美的
cluster	n.一簇，一群
aphid	n.蚜虫
underside	n.底面，下侧
colony	n.一群
sticky	a.粘的
scurry	v.小步跑
swarm	v.聚集
ingenuity	n.机灵
astronomy	n.天文学
relative	a.相对的
infinitely	ad.无限地，无穷地
solar	a.太阳系的
Venus	n.金星
Mars	n.火星
orbit	n.运行轨道
astronomical	a.天文学的
generate	v.产生
particle	n.微粒，粒子
Jupiter	n.木星
blot	v.遮暗
analyse	v.分析
bacteria	n.细菌
oxygen	n.氧气
realm	n.领域
endeavour	n.努力
boundary	n.界线；边界
pump	v.用泵抽
overtake	v.(坏天气、麻烦等)突然降临
backwater	n.回水河汊
predecessor	n.前任
meadow	n.草地，草场
crown	v.给…戴花环
holly	n.一种冬青植物
wreath	n.花环
occurrence	n.偶发事件
proportion	n.部分
site	v.使位于
spell	v.招致，带来
stall	n.牲口棚
attic	n.顶楼
sweeping	a.范围广大的
critical	a.危急的
juncture	n.时刻，关头
raft	n.木筏
unduly	ad.过度地
foundations	n.地基
stoutly	ad.牢固地，粗壮的
submerge	v.浸没
grapple	v.抓住
alien	a.异国的，外国的
emigrate	v.移居(国外)
absorb	v.全神贯注于
embedded	a.扎牢的
mortally	ad.致命地
comprehensive	a.广泛的；丰富的
milestone	n.里程碑
territory	n.领地；地区
milometer	n.计程表
spire	n.(教堂的)塔尖
retrace	v.返回，重走
stumble	v.趔趄地走
horizon	n.地平线
reservoir	n.水库
lurk	v.潜藏
hinder	v.妨碍
fingerprint	n.指纹
chaos	n.混乱，无秩序
inconceivable	a.不可思议的
veritable	a.真正的，地地道道的
magpie	n.喜欢收藏物品的人
toss	v.扔
discard	v.丢弃
constable	n.警察
ransack	v.洗劫
balcony	n.阳台
fussy	a.大惊小怪的，小题大做的
amass	v.积聚，收集
indiscriminate	a.不加选择的
clutter	n./v.一堆杂物;乱糟糟地堆满
string	n.细线, 细绳
requisite	n.必需品
mania	n.癖好,狂热
sketch	n.草图，图样
remote	a.(机会，可能性)极少的，小的
strong-minded	a.意志坚强的
relaxation	n.休息，娱乐
verify	v.查证，核实
bearing	n.关系，联系
like-minded	a.志趣相投的
specimen	n.标本
constructively	ad.有益的，积极的
contented	a.心满意足的
boredom	n.烦恼，无聊
punctuality	n.准时
rural	ad.农村的
disregard	v.不顾，无视
intellectual	n.知识分子
abstruse	a.深奥的
coordinate	v.协调
reproach	v.责备
puncture	v.刺破(轮胎)
diversion	n.改道，绕道
trial	n.讨厌的事、人
fraction	n.很小一点儿
flourish	n.挥舞(打手势)
microscopic	a.微小的
adamant	a.坚定的，不动摇的
